;;
;; Table of predefined combinations for Vietnamese Telex/VNI users.
;;
;; This table is generated from the original table from the branch `v3`.
;; Once this table is manually edit, the generator must be disabled and
;; any further udpate must be done carefully.
;;
;; Copyright (c) 2008 - 2010 Thach-Anh Tran
;; Copyright (c) 2013 Ky-Anh Huynh
;;
;; This work is part of `TheSLinux` distribution.
;; This work is distributed under the terms of the license GPL (v2).
;; To use this work you must read and accept the license that's found at
;;   http://www.gnu.org/licenses/gpl-2.0.html
;;
a	a	-
d	d	-
e	e	-
g	g	-
i	i	-
k	k	-
o	o	-
q	q	-
u	u	-
y	y	-
aa	â	-
ac	ac	-
af	à	-
ai	ai	-
aj	ạ	-
am	am	-
an	an	-
ao	ao	-
ap	ap	-
ar	ả	-
as	á	-
at	at	-
au	au	-
aw	ă	-
ax	ã	-
ay	ay	-
dd	đ	-
ec	ec	-
ee	ê	-
ef	è	-
ej	ẹ	-
em	em	-
en	en	-
eo	eo	-
ep	ep	-
er	ẻ	-
es	é	-
et	et	-
ex	ẽ	-
gi	gi	-
ia	ia	-
ic	ic	-
ie	ie	-
if	ì	-
ij	ị	-
im	im	-
in	in	-
ip	ip	-
ir	ỉ	-
is	í	-
it	it	-
iu	iu	-
ix	ĩ	-
oa	oa	-
oc	oc	-
oe	oe	-
of	ò	-
oi	oi	-
oj	ọ	-
om	om	-
on	on	-
oo	ô	-
op	op	-
or	ỏ	-
os	ó	-
ot	ot	-
ow	ơ	-
ox	õ	-
qu	qu	-
ua	ua	-
uc	uc	-
uf	ù	-
ui	ui	-
uj	ụ	-
um	um	-
un	un	-
uo	uo	-
up	up	-
ur	ủ	-
us	ú	-
ut	ut	-
uw	ư	-
ux	ũ	-
uy	uy	-
ye	ye	-
yf	ỳ	-
yj	ỵ	-
yn	yn	-
yr	ỷ	-
ys	ý	-
yt	yt	-
yx	ỹ	-
aaa	aa	-
aac	aac	-
aaf	ầ	-
aaj	ậ	-
aam	âm	-
aan	ân	-
aap	aap	-
aar	ẩ	-
aas	ấ	-
aat	aat	-
aau	âu	-
aax	ẫ	-
aay	ây	-
ach	ach	-
acj	ạc	-
acs	ác	-
aff	af	-
aif	ài	-
aij	ại	-
air	ải	-
ais	ái	-
aix	ãi	-
ajj	aj	-
amf	àm	-
amj	ạm	-
amr	ảm	-
ams	ám	-
amx	ãm	-
anf	àn	-
ang	ang	-
anh	anh	-
anj	ạn	-
anr	ản	-
ans	án	-
anx	ãn	-
aof	ào	-
aoj	ạo	-
aor	ảo	-
aos	áo	-
aox	ão	-
apj	ạp	-
aps	áp	-
arr	ar	-
ass	as	-
atj	ạt	-
ats	át	-
auf	àu	-
auj	ạu	-
aur	ảu	-
aus	áu	-
awc	awc	-
awf	ằ	-
awj	ặ	-
awm	ăm	-
awn	ăn	-
awp	awp	-
awr	ẳ	-
aws	ắ	-
awt	awt	-
aww	aw	-
awx	ẵ	-
axx	ax	-
ayf	ày	-
ayj	ạy	-
ayr	ảy	-
ays	áy	-
ayx	ãy	-
ddd	dd	-
ecj	ẹc	-
ecs	éc	-
eec	eec	-
eee	ee	-
eef	ề	-
eej	ệ	-
eem	êm	-
een	ên	-
eep	eep	-
eer	ể	-
ees	ế	-
eet	eet	-
eeu	êu	-
eex	ễ	-
eff	ef	-
ejj	ej	-
emf	èm	-
emj	ẹm	-
emr	ẻm	-
ems	ém	-
emx	ẽm	-
enf	èn	-
eng	eng	-
enj	ẹn	-
enr	ẻn	-
ens	én	-
enx	ẽn	-
eof	èo	-
eoj	ẹo	-
eor	ẻo	-
eos	éo	-
eox	ẽo	-
epj	ẹp	-
eps	ép	-
err	er	-
ess	es	-
etj	ẹt	-
ets	ét	-
exx	ex	-
gif	gì	-
gir	gỉ	-
gis	gí	-
iaf	ìa	-
iaj	ịa	-
iar	ỉa	-
ias	ía	-
iax	ĩa	-
ich	ich	-
icj	icj	-
ics	íc	-
iee	iee	-
iff	if	-
imf	ìm	-
imj	ịm	-
imr	ỉm	-
ims	ím	-
imx	ĩm	-
inf	ìn	-
inh	inh	-
inj	ịn	-
inr	ỉn	-
ins	ín	-
inx	ĩn	-
ipj	ịp	-
ips	íp	-
irr	ir	-
iss	is	-
itj	ịt	-
its	ít	-
iuf	ìu	-
iuj	ịu	-
iur	ỉu	-
ius	íu	-
iux	ĩu	-
ixx	ix	-
oac	oac	-
oaf	òa	oà
oai	oai	-
oaj	ọa	oạ
oam	oam	-
oan	oan	-
oao	oao	-
oar	ỏa	oả
oas	óa	oá
oat	oat	-
oaw	oaw	-
oax	õa	oã
oay	oay	-
ocj	ọc	-
ocs	óc	-
oef	òe	-
oej	ọe	oẹ
oeo	oeo	-
oer	ỏe	oẻ
oes	óe	oé
oet	oet	-
ofa	òa	oà
off	of	-
oif	òi	-
oij	ọi	-
oir	ỏi	-
ois	ói	-
oix	õi	-
oja	ọa	oạ
oje	ọe	oẹ
ojj	oj	-
omf	òm	-
omj	ọm	-
omr	ỏm	-
oms	óm	-
omx	õm	-
onf	òn	-
ong	ong	-
onj	ọn	-
onr	ỏn	-
ons	ón	-
onx	õn	-
ooc	ôc	-
oof	ồ	-
ooi	ôi	-
ooj	ộ	-
oom	ôm	-
oon	ôn	-
ooo	oo	-
oop	oop	-
oor	ổ	-
oos	ố	-
oot	ôt	-
oox	ỗ	-
opj	ọp	-
ops	óp	-
ora	ỏa	oả
ore	ỏe	oẻ
orr	or	-
osa	óa	oá
ose	óe	oé
oss	os	-
otj	ọt	-
ots	ót	-
owf	ờ	-
owi	ơi	-
owj	ợ	-
owm	ơm	-
own	ơn	-
owp	owp	-
owr	ở	-
ows	ớ	-
owt	owt	-
oww	ow	-
owx	ỡ	-
oxa	oã	oã
oxx	ox	-
uaa	uaa	-
uaf	ùa	-
uaj	ụa	-
uar	ủa	-
uas	úa	-
uax	ũa	-
ucj	ục	-
ucs	úc	-
uff	uf	-
ufy	ùy	uỳ
uif	ùi	-
uij	ụi	-
uir	ủi	-
uis	úi	-
uix	ũi	-
ujj	uj	-
ujy	ụy	uỵ
umf	ùm	-
umj	ụm	-
umr	ủm	-
ums	úm	-
umx	ũm	-
unf	ùn	-
ung	ung	-
unj	ụn	-
unr	ủn	-
uns	ún	-
unx	ũn	-
uoo	uoo	-
uow	uow	-
upj	ụp	-
ups	úp	-
urr	ur	-
ury	ủy	uỷ
uss	us	-
usy	úy	uý
utj	ụt	-
uts	út	-
uwa	ưa	-
uwc	uwc	-
uwf	ừ	-
uwi	uwi	-
uwj	ự	-
uwn	ưn	-
uwo	uwo	-
uwr	ử	-
uws	ứ	-
uwt	uwt	-
uwu	ưu	-
uww	uw	-
uwx	ữ	-
uxx	ux	-
uxy	ũy	uỹ
uyc	uyc	-
uye	uye	-
uyf	ùy	uỳ
uyj	ụy	uỵ
uyn	uyn	-
uyr	ủy	uỷ
uys	úy	uý
uyt	uyt	-
uyu	uyu	-
uyx	ũy	uỹ
yee	yee	-
ynh	ynh	-
yrr	yr	-
yss	ys	-
yts	ýt	-
yxx	yx	-
aacj	ậc	-
aacs	ấc	-
aamf	ầm	-
aamj	ậm	-
aamr	ẩm	-
aams	ấm	-
aamx	ẫm	-
aanf	ần	-
aang	âng	-
aanj	ận	-
aanr	ẩn	-
aans	ấn	-
aanx	ẫn	-
aapj	ập	-
aaps	ấp	-
aatj	ật	-
aats	ất	-
aauf	ầu	-
aauj	ậu	-
aaur	ẩu	-
aaus	ấu	-
aaux	ẫu	-
aayf	ầy	-
aayj	ậy	-
aayr	ẩy	-
aays	ấy	-
aayx	ẫy	-
achj	ạch	-
achs	ách	-
acjj	acj	-
acss	acs	-
aiff	aif	-
aijj	aij	-
airr	air	-
aiss	ais	-
aixx	aix	-
amff	amf	-
amjj	amj	-
amrr	amr	-
amss	ams	-
amxx	amx	-
anff	anf	-
angf	àng	-
angj	ạng	-
angr	ảng	-
angs	áng	-
angx	ãng	-
anhf	ành	-
anhj	ạnh	-
anhr	ảnh	-
anhs	ánh	-
anhx	ãnh	-
anjj	anj	-
anrr	anr	-
anss	ans	-
anxx	anx	-
aoff	aof	-
aojj	aoj	-
aorr	aor	-
aoss	aos	-
aoxx	aox	-
apjj	apj	-
apss	aps	-
atjj	atj	-
atss	ats	-
auff	auf	-
aujj	auj	-
aurr	aur	-
auss	aus	-
awcj	ặc	-
awcs	ắc	-
awmf	ằm	-
awmj	ặm	-
awmr	ẳm	-
awms	ắm	-
awmx	ẵm	-
awnf	ằn	-
awng	ăng	-
awnj	ặn	-
awnr	ẳn	-
awns	ắn	-
awnx	ẵn	-
awpj	ặp	-
awps	ắp	-
awtj	ặt	-
awts	ắt	-
ayff	ayf	-
ayjj	ayj	-
ayrr	ayr	-
ayss	ays	-
ayxx	ayx	-
ecjj	ecj	-
ecss	ecs	-
eech	eech	-
eecj	ệc	-
eemf	ềm	-
eemj	ệm	-
eemr	ểm	-
eems	ếm	-
eemx	ễm	-
eenf	ền	-
eeng	êng	-
eenh	ênh	-
eenj	ện	-
eenr	ển	-
eens	ến	-
eenx	ễn	-
eepj	ệp	-
eeps	ếp	-
eerr	eer	-
eess	ees	-
eetj	ệt	-
eets	ết	-
eeuf	ều	-
eeuj	ệu	-
eeur	ểu	-
eeus	ếu	-
eeux	ễu	-
emff	emf	-
emjj	emj	-
emrr	emr	-
emss	ems	-
emxx	emx	-
enff	enf	-
engf	èng	-
engr	ẻng	-
engs	éng	-
enjj	enj	-
enrr	enr	-
enss	ens	-
enxx	enx	-
eoff	eof	-
eojj	eoj	-
eorr	eor	-
eoss	eos	-
eoxx	eox	-
epjj	epj	-
epss	eps	-
etjj	etj	-
etss	ets	-
gifa	già	-
giff	gif	-
gira	giả	-
girr	gir	-
giss	gis	-
iaff	iaf	-
iajj	iaj	-
iarr	iar	-
iass	ias	-
iaxx	iax	-
ichj	ịch	-
ichs	ích	-
icjh	ịch	-
icjj	icj	-
icss	ics	-
ieec	iêc	-
ieef	iề	-
ieej	iệ	-
ieem	iêm	-
ieen	iên	-
ieep	ieep	-
ieer	iể	-
iees	iế	-
ieet	ieet	-
ieeu	iêu	-
ieex	iễ	-
imff	imf	-
imjj	imj	-
imrr	imr	-
imss	ims	-
imxx	imx	-
inff	inf	-
inhf	ình	-
inhj	ịnh	-
inhr	ỉnh	-
inhs	ính	-
inhx	ĩnh	-
injj	inj	-
inrr	inr	-
inss	ins	-
inxx	inx	-
ipjj	ipj	-
ipss	ips	-
itjj	itj	-
itss	its	-
iuff	iuf	-
iujj	iuj	-
iurr	iur	-
iuss	ius	-
iuxx	iux	-
oach	oach	-
oacj	oạc	-
oacs	oác	-
oaff	oaf	-
oafi	oài	-
oafm	oàm	!
oafn	oàn	-
oaif	oài	-
oaij	oại	-
oair	oải	-
oais	oái	-
oaix	oãi	-
oajc	oạc	-
oaji	oại	-
oajj	oaj	-
oajm	oạm	!
oajn	oạn	!
oajt	oạt	!
oamj	oạm	-
oanf	oàn	-
oang	oang	-
oanh	oanh	-
oanj	oạn	-
oanr	oản	-
oans	oán	-
oanx	oãn	-
oaos	oáo	-
oari	oải	-
oarn	oản	-
oarr	oar	-
oasc	oác	-
oasi	oái	-
oasn	oán	-
oaso	oáo	-
oass	oas	-
oast	oát	-
oasy	oáy	-
oatj	oạt	-
oats	oát	-
oawc	oawc	-
oawf	oằ	-
oawj	oặ	-
oawn	oăn	-
oawr	oẳ	-
oaws	oắ	-
oawt	oawt	-
oawx	oẵ	-
oaxn	oãn	!
oaxx	oax	-
oays	oáy	-
ocjj	ocj	-
ocss	ocs	-
oeff	oef	-
oejj	oej	-
oejo	oẹo	-
oejt	oẹt	-
oeoj	oẹo	-
oeor	oẻo	-
oern	oẻn	-
oero	oẻo	-
oerr	oer	-
oess	oes	-
oest	oét	-
oetj	oẹt	-
oets	oét	-
ofam	oàm	!
oiff	oif	-
oijj	oij	-
oirr	oir	-
oiss	ois	-
oixx	oix	-
ojac	oạc	!
ojai	oại	-
ojam	oạm	!
ojan	oạn	!
ojat	oạt	!
omff	omf	-
omjj	omj	-
omrr	omr	-
omss	oms	-
omxx	omx	-
onff	onf	-
ongf	òng	-
ongj	ọng	-
ongr	ỏng	-
ongs	óng	-
ongx	õng	-
onjj	onj	-
onrr	onr	-
onss	ons	-
onxx	onx	-
oocj	ộc	-
oocs	ốc	-
ooif	ồi	-
ooij	ội	-
ooir	ổi	-
oois	ối	-
ooix	ỗi	-
oomf	ồm	-
oomj	ộm	-
oomr	ổm	-
ooms	ốm	-
oomx	ỗm	-
oonf	ồn	-
oong	ông	-
oonj	ộn	-
oonr	ổn	-
oons	ốn	-
oonx	ỗn	-
oooc	oooc	-
ooof	oò	-
oooj	oọ	-
ooon	ooon	-
ooor	oỏ	-
ooos	oó	-
oopj	ộp	-
oops	ốp	-
ootj	ột	-
oots	ốt	-
opjj	opj	-
opss	ops	-
orai	oải	-
oran	oản	!
osan	oán	!
osao	oáo	-
osay	oáy	-
otjj	otj	-
otss	ots	-
owff	owf	-
owif	ời	-
owij	ợi	-
owir	ởi	-
owis	ới	-
owix	ỡi	-
owjj	owj	-
owmf	ờm	-
owmj	ợm	-
owmr	ởm	-
owms	ớm	-
owmx	ỡm	-
ownf	ờn	-
ownj	ợn	-
ownr	ởn	-
owns	ớn	-
ownx	ỡn	-
owpj	ợp	-
owps	ớp	-
owrr	owr	-
owss	ows	-
owtj	ợt	-
owts	ớt	-
owxx	owx	-
oxan	oãn	!
uaaf	uầ	-
uaaj	uậ	-
uaan	uân	-
uaar	uẩ	-
uaas	uấ	-
uaat	uât	-
uaax	uẫ	-
uaff	uaf	-
uajj	uaj	-
uarr	uar	-
uass	uas	-
uaxx	uax	-
ucjj	ucj	-
ucss	ucs	-
uiff	uif	-
uijj	uij	-
uirr	uir	-
uiss	uis	-
uixx	uix	-
umff	umf	-
umjj	umj	-
umrr	umr	-
umss	ums	-
umxx	umx	-
unff	unf	-
ungf	ùng	-
ungj	ụng	-
ungr	ủng	-
ungs	úng	-
ungx	ũng	-
unjj	unj	-
unrr	unr	-
unss	uns	-
unxx	unx	-
uooc	uooc	-
uoof	uồ	-
uooi	uôi	-
uoom	uôm	-
uoon	uôn	-
uoor	uổ	-
uoos	uố	-
uoot	uoot	-
uowc	uowc	-
uowf	ườ	-
uowi	ươi	-
uowj	ượ	-
uowm	ươm	-
uown	ươn	-
uowp	uowp	-
uowr	uở	-
uows	ướ	-
uowt	uowt	-
uoww	uoww	-
uowx	ưỡ	-
upjj	upj	-
upss	ups	-
uryu	uỷu	-
utjj	utj	-
utss	uts	-
uwaf	ừa	-
uwaj	ựa	-
uwar	ửa	-
uwas	ứa	-
uwax	ữa	-
uwcj	ực	-
uwcs	ức	-
uwir	ửi	-
uwng	ưng	-
uwnx	ữn	-
uwow	uwow	-
uwts	ứt	-
uwuf	ừu	-
uwuj	ựu	-
uwur	ửu	-
uwus	ứu	-
uwux	ữu	-
uych	uych	-
uycj	uỵc	-
uyee	uyee	-
uyff	uyf	-
uyjc	uỵc	-
uyjj	uyj	-
uynf	uỳn	-
uynh	uynh	-
uyrr	uyr	-
uyru	uỷu	uỷu
uysc	uýc	-
uyss	uys	-
uyst	uýt	-
uytj	uỵt	-
uyts	uýt	-
uyur	uỷu	-
uyxx	uyx	-
yeef	yề	-
yeem	yêm	-
yeen	yên	-
yees	yế	-
yeet	yeet	-
yeeu	yêu	-
ynhf	ỳnh	-
ynhs	ýnh	-
ytss	yts	-
aangf	ầng	-
aangj	ậng	-
aangr	ẩng	-
aangs	ấng	-
aangx	ẫng	-
achjj	achj	-
achss	achs	-
angff	angf	-
angjj	angj	-
angrr	angr	-
angss	angs	-
angxx	angx	-
anhff	anhf	-
anhjj	anhj	-
anhrr	anhr	-
anhss	anhs	-
anhxx	anhx	-
awngf	ằng	-
awngj	ặng	-
awngr	ẳng	-
awngs	ắng	-
awngx	ẵng	-
eechj	ệch	-
eechs	ếch	-
eecjh	ệch	-
eengs	ếng	-
eenhf	ềnh	-
eenhj	ệnh	-
eenhr	ểnh	-
eenss	eens	-
eepss	eeps	-
eetss	eets	-
engff	engf	-
engrr	engr	-
engss	engs	-
ichjj	ichj	-
ichss	ichs	-
ieecj	iệc	-
ieecs	iếc	-
ieejt	iệt	-
ieemf	iềm	-
ieemj	iệm	-
ieemr	iểm	-
ieems	iếm	-
ieemx	iễm	-
ieenf	iền	-
ieeng	iêng	-
ieenj	iện	-
ieenr	iển	-
ieens	iến	-
ieenx	iễn	-
ieepj	iệp	-
ieeps	iếp	-
ieest	iết	-
ieetj	iệt	-
ieets	iết	-
ieeuf	iều	-
ieeuj	iệu	-
ieeur	iểu	-
ieeus	iếu	-
ieeux	iễu	-
inhff	inhf	-
inhjj	inhj	-
inhrr	inhr	-
inhss	inhs	-
inhxx	inhx	-
oachj	oạch	-
oachs	oách	-
oacjj	oacj	-
oacss	oacs	-
oaiff	oaif	-
oaijj	oaij	-
oairr	oair	-
oaiss	oais	-
oaixx	oaix	-
oamjj	oamj	-
oanff	oanf	-
oangf	oàng	-
oangj	oạnh	-
oangr	oảng	-
oangs	oáng	-
oangx	oãng	-
oanhf	oành	-
oanhj	oạng	-
oanhr	oảnh	-
oanhs	oánh	-
oanjj	oanj	-
oanrr	oanr	-
oanss	oans	-
oanxx	oanx	-
oaoss	oaos	-
oatjj	oatj	-
oatss	oats	-
oawcj	oặc	-
oawcs	oắc	-
oawnf	oằn	-
oawng	oăng	-
oawnr	oẳn	-
oawns	oắn	-
oawnx	oẵn	-
oawtj	oặt	-
oawts	oắt	-
oayss	oays	-
oeojj	oeoj	-
oeorr	oeor	-
oetjj	oetj	-
oetss	oets	-
ongff	ongf	-
ongjj	ongj	-
ongrr	ongr	-
ongss	ongs	-
ongxx	ongx	-
oongf	ồng	-
oongj	ộng	-
oongr	ổng	-
oongs	ống	-
oongx	ỗng	-
ooocj	oọc	-
ooocs	ooóc	-
ooonf	oòn	-
ooong	oong	-
ootss	oots	-
uaanf	uần	-
uaang	uâng	-
uaanj	uận	-
uaanr	uẩn	-
uaans	uấn	-
uaanx	uẫn	-
uaatj	uật	-
uaats	uất	-
ungff	ungf	-
ungjj	ungj	-
ungrr	ungr	-
ungss	ungs	-
ungxx	ungx	-
uoocj	uộc	-
uoocs	uốc	-
uooif	uồi	-
uooij	uội	-
uooir	uổi	-
uoois	uối	-
uooix	uỗi	-
uoojc	uộc	-
uooji	uội	-
uoojt	uột	-
uoomf	uồm	-
uoomj	uộm	-
uooms	uốm	-
uoomx	uỗm	-
uoonf	uồn	-
uoong	uông	-
uoonj	uộn	-
uoonr	uổn	-
uoons	uốn	-
uoonx	uỗn	-
uoosc	uốc	-
uoosi	uối	-
uooss	uoos	-
uoost	uốt	-
uootj	uột	-
uoots	uốt	-
uowcj	ược	-
uowcs	ước	-
uowif	ười	-
uowij	ượi	-
uowir	ưởi	-
uowis	ưới	-
uowix	ưỡi	-
uowmf	ườm	-
uowmj	ượm	-
uowms	ướm	-
uownf	ườn	-
uowng	ương	-
uownj	ượn	-
uownr	ưởn	-
uowns	ướn	-
uownx	ưỡn	-
uowpj	ượp	-
uowps	ướp	-
uowts	ướt	-
uowwc	uowwc	-
uowwf	ườ	-
uowwi	ươi	-
uowwj	ượ	-
uowwm	ươm	-
uowwn	ươn	-
uowwp	uowwp	-
uowwr	uở	-
uowws	ướ	-
uowwt	uowwt	-
uowwx	ưỡ	-
uwngf	ừng	-
uwngj	ựng	-
uwngr	ửng	-
uwngs	ứng	-
uwngx	ững	-
uwowc	uwowc	-
uwowf	ườ	-
uwowi	ươi	-
uwowj	ượ	-
uwowm	ươm	-
uwown	ươn	-
uwowp	uwowp	-
uwowr	ưở	-
uwows	ướ	-
uwowt	uwowt	-
uwowu	ươu	-
uwowx	ưỡ	-
uychj	uỵch	-
uycjj	uycj	-
uyeef	uyề	-
uyeen	uyên	-
uyees	uyế	-
uyeet	uyeet	-
uyfnh	uỳnh	-
uynff	uynf	-
uynhf	uỳnh	-
uynhs	uýnh	-
uysnh	uýnh	-
uytjj	uytj	-
uytss	uyts	-
uyurr	uyur	-
yeemr	yểm	-
yeems	yếm	-
yeenf	yền	-
yeeng	yêng	-
yeenj	yện	-
yeenr	yển	-
yeens	yến	-
yeenx	yễn	-
yeest	yết	-
yeetj	yệt	-
yeets	yết	-
yeeur	yểu	-
yeeus	yếu	-
ynhff	ynhf	-
ynhss	ynhs	-
ieengf	iềng	-
ieengj	iệng	-
ieengr	iểng	-
ieengs	iếng	-
ieengx	iễng	-
oachjj	oachj	-
oachss	oachs	-
oangff	oangf	-
oangjj	oangj	-
oangrr	oangr	-
oangss	oangs	-
oangxx	oangx	-
oanhff	oanhf	-
oanhjj	oanhj	-
oanhrr	oanhr	-
oanhss	oanhs	-
oawngf	oằng	-
oawngs	oắng	-
oawngx	oẵng	-
ooongf	oòng	-
uaangf	uầng	-
uaangr	uẩng	-
uoongf	uồng	-
uoongj	uộng	-
uoongr	uổng	-
uoongs	uống	-
uoongx	uỗng	-
uowngf	ường	-
uowngj	ượng	-
uowngr	ưởng	-
uowngs	ướng	-
uowngx	ưỡng	-
uowwcj	ược	-
uowwcs	ước	-
uowwif	ười	-
uowwij	ượi	-
uowwir	ưởi	-
uowwis	ưới	-
uowwix	ưỡi	-
uowwmf	ườm	-
uowwmj	ượm	-
uowwms	ướm	-
uowwnf	ườn	-
uowwng	ương	-
uowwnj	ượn	-
uowwnr	ưởn	-
uowwns	ướn	-
uowwnx	ưỡn	-
uowwpj	ượp	-
uowwps	ướp	-
uowwts	ướt	-
uwowcj	ược	-
uwowcs	ước	-
uwowif	ười	-
uwowij	ượi	-
uwowir	ưởi	-
uwowis	ưới	-
uwowix	ưỡi	-
uwowmf	ườm	-
uwowmj	ượm	-
uwowms	ướm	-
uwownf	ườn	-
uwowng	ương	-
uwownj	ượn	-
uwownr	ưởn	-
uwowns	ướn	-
uwownx	ưỡn	-
uwowpj	ượp	-
uwowps	ướp	-
uwowtj	ượt	-
uwowts	ướt	-
uwowuj	ượu	-
uwowus	ướu	-
uychjj	uychj	-
uyeejn	uyện	-
uyeejt	uyệt	-
uyeenf	uyền	-
uyeenj	uyện	-
uyeenr	uyển	-
uyeens	uyến	-
uyeenx	uyễn	-
uyeern	uyển	-
uyeetj	uyệt	-
uyeets	uyết	-
uyeexn	uyễn	-
uynhff	uynhf	-
uynhss	uynhs	-
uowwngf	ường	-
uowwngj	ượng	-
uowwngr	ưởng	-
uowwngs	ướng	-
uowwngx	ưỡng	-
uwowngf	ường	-
uwowngj	ượng	-
uwowngr	ưởng	-
uwowngs	ướng	-
uwowngx	ưỡng	-
